"f" = (/turf/simulated/floor/plating,/area/greston/surfacebase/outside/outside3)
"g" = (/turf/simulated/open/lumos4,/area/greston/surfacebase/outside/outside3)
"n" = (/obj/effect/landmark/map_data/lumos4,/turf/simulated/open/lumos4,/area/greston/surfacebase/outside/outside3)
"q" = (/turf/simulated/floor/tiled,/area/greston/surfacebase/outside/outside3)
"s" = (/turf/simulated/mineral/lumos4,/area/greston/surfacebase/outside/outside3)
"B" = (/obj/machinery/door/firedoor/glass/hidden/steel{dir = 2},/turf/simulated/floor/tiled,/area/hallway/primary/central_three)
"F" = (/turf/simulated/wall/r_wall,/area/greston/surfacebase/outside/outside3)
"L" = (/obj/structure/lattice,/turf/simulated/open/lumos4,/area/greston/surfacebase/outside/outside3)
"M" = (/turf/simulated/wall,/area/greston/surfacebase/outside/outside3)
"Q" = (/turf/simulated/wall/solidrock,/area/greston/surfacebase/outside/outside3)
"S" = (/turf/simulated/shuttle/wall/voidcraft/green{hard_corner = 1},/area/hallway/primary/central_three)
"T" = (/turf/simulated/floor/tiled,/area/hallway/primary/central_three)
"W" = (/turf/simulated/floor/holofloor/tiled/dark,/area/hallway/primary/central_three)
"Z" = (/turf/unsimulated/mineral/lumos4,/area/greston/surfacebase/outside/outside3)

(1,1,1) = {"
ZZZZZZZZZZZZZZZZZZZZZZZZZZZZZZZZZZZZZZZZZZZZZZZZZZZZZZZZZZZZZZZZZZZQQQQQQQQQQZZZZZZZZZZZZZZZZZZZZZZZZZZZZZZZZZZZZZZZZZZZZZZZZZZZZZZZZZZZZZZZ
ZZZZZZZZZZZZZZZZZZZZZZZZZZZZZZZZZZZZZZZZZZZZZZZZZZZZZZZZZZZZZZZZZZZQQQQQQQQQQsssZZZZZZZZZZZZZZZZZZZZZZZZZZZZZZZZZZZZZZZZZZZZZZZZZZZZZZZZZZZZ
ZZZZZZZZZZZZZZZZZZZZZZZZZZZZZZZZZZZZZZZZZZZZZZZZZZZZZZZZZZZZZZZZZZZQQQQQQQQQQsMsZZZZZZZZZZZZZZZZZZZZZZZZZZZZZZZZZZZZZZZZZZZZZZZZZZZZZZZZZZZZ
QQQQQQQQQQQQQQQQQQQQQZZZQQQQQQQQQQQQQQQQQZZZZZZZZZZQsssssssssssssQQQQQQQQQQQQsMsQQQQQQQQQQQQQZZZZZZZZZZZQQQQQQQQQQQQQQQQQQQQQQQQQQQQQQQQQQZZ
QQQggQQQQQQQQQQQQQQQQZZZQQQQQQQQQQQQQQQQQZZZZZZZZZZQsMMMMMMMMMMMsQQQQQQQQQQQQsMsssQQQQQQQQQQQZZZZZZZZZZZQQQQQQQQQsssssssssssssssssssssssQQZZ
QQQggQQQQQQQQQQQQQQQQZZZQQQQQQQQQQQQQQQQQZZZZZZZZZZQsMfffffffffMsQQQQQQQQQQQQsMffsQQQQQQQQQQQZZZZZZZZZZZQQQQQQQQQsssssssssssssssssssssssQQZZ
QQQggggQQQQQQQQQQQQQQZZZQQQQQQQQQQQQQQQQQZZZZZZZZZZQsMfffffffffMsQQQQQQQQQQQQsMffsQQQQQQQQQQQZZZZZZZZZZZQQQQQQQQQsssMMMMMMMMMsssssssssssssZZ
gggggggQQQQQQQQQQQQQQZZZQQQQQQQQQQQQQQQQQZZZZZZZZZZQsMfffffffffMsQQQQQQQQQQQQsMfssQQQQQQQQQQQZZZZZZZZZZZQQQQQQQQQssffffffffffffssssffsssssZZ
gggggggQQQQQQQQQQQQQQZZZQQQQQQQQQQQQQQQQQZZZZZZZZZZQsMfffffffffMsQQQQQQQQQQQQsMffsQQQQQQQQQQQZZZZZZZZZZZQQQQQQQQQssfffffffffffffffffsMssssZZ
gggggggggQQQQQQQQQQQQZZZQQQQQQQQQQQQQQQQQZZZZZZZZZZQsMfffffffffMsQQQQQQQQQQQQsMsfsQQQQQQQQQQQZZZZZZZZZZZQQQQQQQQQssffsssMMMMMMMMsssffMssssZZ
gggggggggQQQQQQQQQQQQZZZQQQQQQQQQQQQQQQQQZZZZZZZZZZQsMfffffffffMssssssssssssssMsfMsssssssssssssssssssssssssssssssssffssssssssssssssffsssssZZ
gggggggggQQQQQQQQQQQQZZZQQQQQQQQQQQQQQQQQZZZZZZZZZZQsMMMMMMMMMMMMMMMMMMMMMMMMMMsfMMsssssssMMMMMMMMMssssssssssssssssffsssssssssssssssfsssssZZ
gggggggggQQQQQQQQQQQQZZZQQQQQQQQQQQQQQQQQZZZZZZZZZZQsMffffffffffffssfffffsffffffffffffffffffffffsssffsffffsffsfffffffffssssQQQQQsssfffssssZZ
ggggggggggQQQQQQQQQQZZQQQgQQQQQQQQgQQQQQQQQQQQQQQQQQsMffffffffffsffffffffffffffffffffffffffffffffffffffffffffffffffffffssssQQQQQsssfffssssZZ
ggggggggggQggQgQQgQQQQQQggggggggggggggggQQggQQQQQQQQsMffsssssssssssssssssssssssssssMMMMMffssssssssMMMMMMMMMMMMMMsssfsssssssQQQQQsssfffMsssZZ
gggggggggggggggggggggggggggggggggggggggggggggQQggsQQsMffssssssssssssssssssssssssssssssssffMssssssssssssssssssssssssfsssssssQQQQQssssffMsssZZ
gggggggggggggggggggggggggggggggggggggggggggggggggsQQsMffsssssssssssssssssssssssssssssssMffMQQZZZZZZZZZZZQQQQQQQQQQQQQQQQQQQQQQQQsssMffMsssZZ
gggggggggggggggggggggggggggggggggggggggggggggggggssssMffsssssssssssssssssssssssssssssssMffMQQZZZZZZZZZZZQQQQQQQQQQQQQQQQQQQQQQQQsssMfQssssZZ
ggggggggggggggggggggggggggggggggggggggggggggggggggMMMMffMMMMMMMMMMMMMMMMMMMMMMMMMMMMMMMMMfMMMMMMMMMMMMMMMMMMMMMMMMMMMMMMMMMMMMMMMMMMffMsssZZ
ggggggggggggggggggggggggggggggggggggggggggggggggggMfffffffffffffffffffMqqqqqqqqqqqqqqqqqqqqqqqqqqqqqqqqqqqqqqqqqqqqqqqqqqqqqqqqqqqqMffMsssZZ
ggggggggggggggggggggggggggggggggggggggggggggggggggMfffffffffffffffffffMqqqqqqqqqqqqqqqqqqqqqqqqqqqqqqqqqqqqqqqqqqqqqqqqqqqqqqqqqqqqMffMsssZZ
ggggggggggggggggggggggggggggggggggggggggggggggggggMMMMMMMMMMMMMMMMMMffMqqqqqqqqqqqqqqqqqqqqqqqqqqqqqqqqqqqqqqqqqqqqqqqqqqqqqqqqqqqqMffMsssZZ
ggggggggggggggggggggggggggggggggggggggggggggggggggMqqqqqqqqqqqqqqqqMffMqqqqqqqqqqqqqqqqqqqqqqqqqqqqqqqqqqqqqqqqqqqqqqqqqqqqqqqqqqqqMffMsssZZ
ggggggggggggggggggggggggggggggggggggggggggggggggggMqqqqqqqqqqqqqqqqMffMqqqqqqqqqqqqqqqqqqqqqqqqqqqqqqqqqqqqqqqqqqqqqqqqqqqqqqqqqqqqMffMsssZZ
ggggggggggggggggggggggggggggggggggggggggggggggggggMqqqqqqqqqqqqqqqqMffMqqqqqqqqqqqqqqqqqqqqqqqqqqqqqqqqqqqqqqqqqqqqqqqqqqqqqqqqqqqqMffMsssZZ
ggggggggggggggggggggggggggggggggggggggggggggggggggMqqqqqqqqqqqqqqqqMffMqqqqqqqqqqqqqqqqqqqqqqqqqqqqqqqqqqqqqqqqqqqqqqqqqqqqqqqqqqqqMffMsssZZ
ggggggggggggggggggggggggggggggggggggggggggggggggggMqqqqqqqqqqqqqqqqMffMqqqqqqqqqqqqqqqqqqqqqqqqqqqqqqqqqqqqqqqqqqqqqqqqqqqqqqqqqqqqMffMsssZZ
ggggggggggggggggggggggggggggggggggggggggggggggggggMqqqqqqqqqqqqqqqqMffMqqqqqqqqqqqqqqqqqqqqqqqqqqqqqqqqqqqqqqqqqqqqqqqqqqqqqqqqqqqqMffMsssZZ
ggggggggggggggggggggggggggggggggggggggggggggggggggMqqqqqqqqqqqqqqqqMffMqqqqqqqqqqqqqqqqqqqqqqqqqqqqqqqqqqqqqqqqqqqqqqqqqqqqqqqqqqqqMffMsssZZ
ggggggggggggggggggggggggggggggggggggggggggggggggggMqqqqqqqqqqqqqqqqMffMqqqqqqqqqqqqqqqqqqqqqqqqqqqqqqqqqqqqqqqqqqqqqqqqqqqqqqqqqqqqMffMsssZZ
ggggggggggggggggggggggggggggggggggggggggggggggggggMqqqqqqqqqqqqqqqqMffMqqqqqqqqqqqqqqqqqqqqqqqqqqqqqqqqqqqqqqqqqqqqqqqqqqqqqqqqqqqqMffMsssZZ
ggggggggggggggggggggggggggggggggggggggggggggggggggMqqqqqqqqqqqqqqqqMffMqqqqqqqqqqqqqqqqqqqqqqqqqqqqqqqqqqqqqqqqqqqqqqqqqqqqqqqqqqqqMffMsssZZ
ggggggggggggggggggggggggggggggggggggggggggggggggggMqqqqqqqqqqqqqqqqMffMqqqqqqqqqqqqqqqqqqqqqqqqqqqqqqqqqqqqqqqqqqqqqqqqqqqqqqqqqqqqMffMsssQQ
ggggggggggggggggggggggggggggggggggggggggggggggggggMqqqqqqqqqqqqqqqqMfffqqqqqqqqqqqqqqqqqqqqqqqqqqqqqqqqqqqqqqqqqqqqqqqqqqqqqqqqqqqqMffMsssQQ
ggggggggggggggggggggggggggggggggggggggggggggggggggMqqqqqqqqqqqqqqqqMffMqqqqqqqqqqqqqqqqqqqqqqMMMMMMMMMqqMMMMMMMMMqqqqqqqqqqqqqqqqqqMffMsssQQ
ggggggggggggggggggggggggggggggggggggggggggggggggggMqqqqqqqqqqqqqqqqMffMqqqqqqqqqqqqqqqqqqqqqqMqqTTTTTTTTTTTTTTqqMqqqqqqqqqqqqqqqqqqMffMsssQQ
gggggggggggggggggggggggggggggggggggggggggggggggggMMqqqqqqqqqqqqqqqqMffMqqqqqqqqqqqqqqqqqqqqqqMqqTTTTTTTTTTTTTTqqMqqqqqqqqqqqqqqqqqqMffMsssQQ
ggggggggggggggggggggggggggggggggggggggggggggggggMMqqqqqqqqqqqqqqqqqMffMqqqqqqqqqqqqqqqqqqqqqqMqqTTTTTTTTTTTTTTqqMqqqqqqqqqqqqqqqqqqMffMsssQQ
gggggggggggggggggggggggggggggggggggggggggggggMMMMqqqqqqqqqqqqqqqqqqMffMqqqqqqqqqqqqqqqqqqqqqqMqqqMfMSSWWSSMfMqqqMqqqqqqqqqqqqqqqqqqMffMsssQQ
gggggggggggggggggggggggggggggggggggggggggggggMqqqqqqqqqqqqqqqqqqqqqMffMqqqqqqqqqqqqqqqqqqqqqqMqqqMfMSWWWWSMfMqqqMqqqqqqqqqqqqqqqqqqMffMsssQQ
gggggggggggggggggggggggggggggggggggggggggggggMqqqqqqqqqqqqqqqqqqqqqMffMqqqqqqqqqqqqqqqqqqqqqqMqqqMfMSWWWWSMfMqqqMqqqqqqqqqqqqqqqqqqMffMsssQQ
ggggggggggggggggggggggggggggggggggggggggggggMMqqqqqqqqqqqqqqqqqqqqqMffMqqqqqqqqqqqqqqqqqqqqqqMqqqMfMSWWWWSMfMqqqMqqqqqqqqqqqqqqqqqqMffMsssQQ
gggggggggggggggggggggggggggggggggggggggggggMMqqqqqqqqqqqqqqqqqqqqqqMffMqqqqqqqqqqqqqqqqqqqqqqMqqqMfMSWWWWSMfMqqqMqqqqqqqqqqqqqqqqqqMffMssssQ
gggggggggggggggggggggMMMMMMMMMMMMMMMMMMMMMMMqqqqqqqqqqqqqqqqqqqqqqqMffMqqqqqqqqqqqqqqqqqqqqqqMqqqMfMSSSSSSMfMqqqMqqqqqqqqqqqqqqqqqqMMfMMMMsQ
gggggggggggggggggggggMqqqqqqqqqqqqqqqqqqqqqqqqqqqqqqqqqqqqqqqqqqqqqMffMqqqqqqqqqqqqqqqqqqqqqqMqqqMfMMMMMMMMfMqqqMqqqqqqqqqqqqqqqqqqqqqqqqMsQ
gggggggggggggggggggggMqqqqqqqqqqqqqqqqqqqqqqqqqqqqqqqqqqqqqqqqqqqqqMffMqqqqqqqqqqqqqqMMMMMMMMMqqqfffffffffffMqqqMqqqqqqqqqqqqqqqqqqqqqqqqMsQ
gggggggggggggggggggggMqqqqqqqqqqqqqqqqqqqqqqqqqqqqqqqqqqqqqqqqqqqqqMffMqqqqqqqqqqqqqqMqqqqqqqqqqqMffffffffffMqqqMqqqqqqqqqqqqqqqqqqqqqqqqMsQ
gggggggggggggggggggggMqqqqqqqqqqqqqqqqqqqqqqqqqqqqqqqqqqqqqqqqqqqqqMffMqqqqqqqqqqqqqqMqqqqqqqqqqqMfMMMMMMMMMMqqqMqqqqqqqqqqqqqqqqqqqqqqqqMsQ
gggggggggggggggggggggMqqqqqqqqqqqqqqqqqqqqqqqqqqqqqqqqqqqqqqqqqqqqqMffMqqqqqqqqqqqqqqMqqqqqqqqqqqMqqMqffffqqMqqqMqqqqqqqqqqqqqqqqqqqqqqqqMsQ
gggggggggggggggggggggMqqqqqqqqqqqqqqqqqqqqqqqqqqqqqqqqqqqqqqqqqqqqqMffMqqqqqqqqqqqqqqMqqqqqqqqqqqMqqMqffffqqMqqqMqqqqqqqqqqqqqqqqqqqqqqqqMsQ
gggggggggggggggggggggMqqqqqqqqqqqqqqqqqqqqqqqqqqqqqqqqqqqqqqqqqqqqqMffMqqqqqqqqqqqqqqMqqqqqqqqqqqMqqMfffffqqMqqqMqqqqqqqqqqqqqqqqqqqqqqqqMsQ
gggggggggggggggggggggMqqqqqqqqqqqqqqqqqqqqqqqqqqqqqqqqqqqqqqqqqqqqqMffMqqqqqqqqqqqqqqMqqqqqqqqqqqMqqffffffqqMqqqMqqqqqqqqqqqqqqqqqqqqqqqqMsQ
gggggggggggggggggggggMMMMMMMqqqqqqqqqqqqqqqqqqqqqqqqqqqqqqqqqqqqqqqMffMMMMMMMMMMMMMMMMqqqqqqqqqqqMqqMfffffqqMqqqMqqqqqqqqqqqqqqqqqqqqqqqqMsQ
gggggggggggggggggggggggggggMqqqqqqqqqqqqqqqqqqqqqqqqqqqqqqqqqqqqqqqMfffMqqqqqqqqqqqqqqqqqqqqqqqqqMqqMfffffqqMqqqMqqqqqqqqqqqqqqqqqqqqqqqqMsQ
gggggggggggggggggggggggggggMqqqqqqqqqqqqqqqqqqqqqqqqqqqqqqqqqqqqqqqMfffMqqqqqqqqqqqqqqqqqqqqqqqqqMqqMffffffqfqqqMqqqqqqqqqqqqqqqqqqqqqqqqMsQ
gggggggggggggggggggggggggggMqqqqqqqqqqqqqqqqqqqqqqqqqqqqqqqqqqqqqqqMffffqqqqqqqqqqqqqqqqqqqqqqqqqMqqMqqqqfqqfqqqMqqqqqqqqqqqqqqqqqqqqqqqqMsQ
gggggggggggggggggggggggggggMqqqqqqqqqqqqqqqqqqqqqqqqqqqqqqqqqqqqqqqMfffMqqqMfMMMMMMMMMMMMMMMMMMMMMffMMMMMMMMMqqqMqqqqqqqqqqqqqqqqqqqqqqqqMsQ
gggggggggggggggggggggggggggMqqqqqqqqqqqqqqqqqqqqqqqqqqqqqqqqqqqqqqqMfffMqqqMffffffffffffffffffffffffffffffffMqqqMqqqqqqqqqqqqqqqqqqqqqqqqMsQ
gggggggggggggggggggggggMMMMMqqqqqqqqqqqqqqqqqqqqqqqqqqqqqqqqqqqqqqqMfffMqqqMffffffffffffffffffffffffffffffffqqqqMqqqqqqqqqqqqqqqqqqqqqqqqMsQ
gggggggggggggggggggggggMqqqqqqqqqqqqqqqqqqqqqqqqqqqqqqqqqqqqqqqqqqqMfffMqqqMffMMMMMMMMMMMMMMfMMMMMMMMMMMMMMMMqqqMqqqqqqqqqqqqqqqqqqqqqqqqMsQ
gggggggggggggggggggggggMqqqqqqqqqqqqqqqqqqqqqqqqqqqqqqqqqqqqqqqqqqqMfffMqqqMffMffffffffffffffffffffMqqqqqqqqqqqqMqqqqqqqqqqqqqqqqqqqqqqqqMsQ
gggggggggggggggggggggggMqqqqqqqqqqqqqqqqqqqqqqqqqqqqqqqqqqqqqqqqqqqMfffMqqqMffMffffffffffffffffffffMqqqqqqqqqqqqMqqqqqqqqqqqqqqqqqqqqqqqqMsQ
gggggggggggggggggggggggMqqqqqqqqqqqqqqqqqqqqqqqqqqqqqqqqqqqqqqqqqqqMfffMqqqMffMffffffffffffffffffffMqqqqqqqqqqqqMqqqqqqqqqqqqqqqqqqqqqqqqMsQ
gggggggggggggggggggggggMqqqqqqqqqqqqqqqqqqqqqqqqqqqqqqqqqqqqqqqqqqqMfffMqqqMffMffffffffffffffffffffMqqqMMMMMMMMMMqqqqqqqqqqqqqqqqqqqqqqqqMsQ
gggggggggggggggggggggggMMMMMqqqqqqqqqqqqqqqqqqqqqqqqqqqqqqqqqqqqqqqMfffMqqqMffMffffffffffffffffffffMqqqMqqqqqqqqqqqqqqqqqqqqqqqqqqqqqqqqqMsQ
gggggggggggggggggggggggggggMqqqqqqqqqqqqqqqqqqqqqqqqqqqqqqqqqqqqqqqMMfMMqqqMffMffffffffffffffffffffMqqqMqqqqqqqqqqqqqqqqqqqqqqqqqqqqqqqqqMsQ
gggggggggggggggggggggggggggMqqqqqqqqqqqqqqqqqqqqqqqqqqqqqqqqqqqqqqqqqqqMqqqMffMffffffffffffffffffffMqqqMqqqqqqqqqqqqqqqqqqqqqqqqqqqqqqqqqMsQ
gggggggggggggggggggggggggggMqqqqqqqqqqqqqqqqqqqqqqqqqqqqqqqqqqqqqqqqqqqqqqqMffMffffffffffffffffffffMqqqMqqqqqqqqqqqqqqqqqqqqqqqqqqqqqqqqqMsQ
gggggggggggggggggggggggggggMqqqqqqqqqqqqqqqqqqqqqqqqqqqqqqqqqqqqqqqqqqqqqqqMffMfffffffffffffffffffffqqqMqqqqqqqqqqqqqqqqqqqqqqqqqqqqqqqqqMsQ
gggggggggggggggggggggggggggMqqqqqqqqqqqqqqqqqqqqqqqqqqqqqqqqqqqqqqqqqqqMqqqMffMfffffffffffffffffffffqqqMqqqqqqqqqqqqqqqqqqqqqqqqqqqqqqqqqMsQ
ggggggggggggMMMMMMMMMMMMMMMMqqqqqqqqqqqqqqqqqqqqqqqqqqqqqqqqqqqqqqqMMfMMqqqMffMffffffffffffffffffffMqqqMqqqqqqqqqqqqqqqqqqqqqqqqqqqqqqqqqMsQ
ggggggggggggMqqqqqqqqqqqqqqqqqqqqqqqqqqqqqqqqqqqqqqqqqqqqqqqqqqqqqqMfffMqqqMffMffffffffffffffffffffMqqqMqqqqqqqqqqqqqqqqqqqqqqqqqqqqqqqqqMsQ
ggggggggggggMqqqqqqqqqqqqqqqqqqqqqqqqqqqqqqqqqqqqqqqqqqqqqqqqqqqqqqMfffMqqqMffMffffffffffffffffffffMqqqMqqqqqqqqqqqqqqqqqqqqqqqqqqqqqqqqqMsQ
ggggggggggggMqqqqqqqqqqqqqqqqqqqqqqqqqqqqqqqqqqqqqqqqqqqqqqqqqqqqqqMfffMqqqMffMffffffffffffffffffffMqqqMqqqqqqqqqqqqqqqqqqqqqqqqqqqqqqqqqMsQ
ggggggggggggMqqqqqqqqqqqqqqqqqqqqqqqqqqqqqqqqqqqqqqqqqqqqqqqqqqqqqqMfffMqqqMffMffffffffffffffffffffMqqqMqqqqqqqqqqqqqqqqqqqqqqqqqqqqqqqqqMsQ
ggggggggggggMqqqqqqqqqqqqqqqqqqqqqqqqqqqqqqqqqqqqqqqqqqqqqqqqqqqqqqMfffMqqqMffMffffffffffffffffffffMqqqMqqqqqqqqqqqqqqqqqqqqqqqqqqqqqqqqqMsQ
ggggggggggggMqqqqqqqqqqqqqqqqqqqqqqqqqqqqqqqqqqqqqqqqqqqqqqqqqqqqqqMfffMqqqMffMffffffffffffffffffffMqqqMqqqqqqqqqqqqqqqqqqqqqqqqqqqqqqqqqMsQ
ggggggggggggMqqqqqqqqqqqqqqqqqqqqqqqqqqqqqqqqqqqqqqqqqqqqqqqqqqqqqqMfffMqqqMffMMMMMMMMMMMMMMfffffffMqqqMqqqqqqqqqqqqqqqqqqqqqqqqqqqqqqqqqMsQ
ggggggggggggMqqqqqqqqqqqqqqqqqqqqqqqqqqqqqqqqqqqqqqqqqqqqqqqqqqqqqqMfffMqqqMffMffffffffffffMfffffffMqqqMqqqqqqqqqqqqqqqqqqqqqqqqqqqqqqqqqMsQ
ggggggggggggMqqqqqqqqqqqqqqqqqqqqqqqqqqqqqqqqqqqqqqqqqqqqqqqqqqqqqqMfffMqqqMfffffffffffffffffffffffMqqqMqqqqqqqqqqqqqqqqqqqqqqqqqqqqqqqqqMsQ
ggggggggggggMqqqqqqqqqqqqqqqqqqqqqqqqqqqqqqqqqqqqqqqqqqqqqqqqqqqqqqMfffMqqqMffMMMMMMMMMMMffMfffffffMqqqMqqqqqqqqqqqqqqqqqqqqqqqqqqqqqqqqqMsQ
ggggggggggggMqqqqqqqqqqqqqqqqqqqqqqqqqqqqqqqqqqqqqqqqqqqqqqqqqqqqqqMfffMqqqMffMqqqqqqqqqMffMfffffffMqqqMqqqqqqqqqqqqqqqqqqqqqqqqqqqqqqqqqMsQ
ggggggggggggMqqqqqqqqqqqqqqqqqqqqqqqqqqqqqqqqqqqqqqqqqqqqqqqqqqqqqqMfffMqqqMfMMqqqqqqqqqMffMfffffffMqqqMqqqqqqqqqqqqqqqqqqqqqqqqqqqqqMMfMMsQ
ggggggggggggMqqqqqqqqqqqqqqqqqqqqqqqqqqqqqqqqqqqqqqqqqqqqqqqqqqqqqqMfffMqqqqqqqqqqqqqqqqMffMfffffffMqqqMqqqqqqqqqqqqqqqqqqqqqqqqqqqqqMffMssQ
ggggggggggggMqqqqqqqqqqqqqqqqqqqqqqqqqqqqqqqqqqqqqqqqqqqqqqqqqqqqqqMfffMqqqqqqqqqqqqqqqqMffMMMMMMMMMqqqMqqqqqqqqqqqqqqqqqqqqqqqqqqqqqMffMssQ
ggggggggggggMqqqqqqqqqqqqqqqqqqqqqqqqqqqqqqqqqqqqqqqqqqqqqqqqqqqqqqMfffMqqqqqqqqqqqqqqqqMfffffffffffqqqMqqqqqqqqqqqqqqqqqqqqqqqqqqqqqMffMssQ
ggggggggggggMqqqqqqqqqqqqqqqqqqqqqqqqqqqqqqqqqqqqqqqMMMMMMMMMMMMMMMMMfMMMMMMMMMMMMMMMqqqMffffffffffMqqqMqqqqqqqqqqqqqqqqqqqqqqqqqqqqqMffMssQ
ggggggggggggMqqqqqqqqqqqqqqqqqqqqqqqqqqqqqqqqqqqqqqqMqqqqqqqqqqqqqqqqqqqqqqqqqqqqqqqMqqqMffffffffffMqqqqqqqqqqqqqqqqqqqqqqqqqqqqqqqqqMffMssQ
ggggggggggggMMMMMMMMqqqqqqqqqqqqqqqqqqqqqqqqqqqqqqqqMqqqqqqqqqqqqqqqqqqqqqqqqqqqqqqqMqqqMfMMMMMMMMfMqqqqqqqqqqqqqqqqqqqqqqqqqqqqqqqqqMffMssQ
ggggggggggsssssssssMqqqqqqqqqqqqqqqqqqqqqqqqqqqqqqqqMqqqqqqqqqqqqqqqqqqqqqqqqqqqqqqqqqqqMfMSSSSSSMfMqqqMqqqqqqqqqqqqqqqqqqqqqqqqqqqqqMffMssQ
gggggggggssssssssssMqqqqqqqqqqqqqqqqqqqqqqqqqqqqqqqqMqqqqqqqqqqqqqqqqqqqqqqqqqqqqqqqqqqqMfMSWWWWSMfMqqqMqqqqqqqqqqqqqqqqqqqqqqqqqqqqqMffMssQ
ggggggggggsssssssssMqqqqqqqqqqqqqqqqqqqqqqqqqqqqqqqqMqqqqqqqqqqqqqqqqqqqqqqqqqqqqqqqMqqqMfMSWWWWSMfMqqqMqqqqqqqqqqqqqqqqqqqqqqqqqqqqqMffMssQ
gggggggggggssssssssMqqqqqqqqqqqqqqqqqqqqqqqqqqqqqqqqMqqqqqqqqqqqqqqqqqqqqqqqqqqqqqqqMqqqMfMSWWWWSMfMqqqMqqqqqqqqqqqqqqqqqqqqqqqqqqqqqMffMssQ
gggggggggggssssssssMqqqqqqqqqqqqqqqqqqqqqqqqqqqqqqqqMqqqqqqqqqqqqqqqqqqqqqqqqqqqqqqqMqqqMqMSWWWWSMqMqqqqqqqqqqqqqqqqqqqqqqqqqqqqqqqqqMffMssQ
ggggggggggsssssssssMqqqqqqqqqqqqqqqqqqqqqqqqqqqqqqqqMqqqqqqqqqqqqqqqqqqqqqqqqqqqqqqqMqqqqqMSSWWSSMqqqqqqqqqqqqqqqqqqqqqqqqqqqqqqqqqqqMffMssQ
gggggggggssssssssssMqqqqqqqqqqqqqqqqqqqqqqqqqqqqqqqqMqqqqqqqqqqqqqqqqqqqqqqqqqqqqqqqMqTTTTTTTBBTTTTTTTqMqqqqqqqqqqqqqqqqqqqqqqqqqqqqqMffMssZ
gggggggggssssssssssMqqqqqqqqqqqqqqqqqqqqqqqqqqqqqqqqMqqqqqqqqqqqqqqqqqqqqqqqqqqqqqqqMqTTTTTTTTTTTTTTTTqMqqqqqqqqqqqqqqqqqqqqMMMMMfMMMMffMssZ
ggggggggggsssssssssFqqqqqqqqqqqqqqqqqqqMMMMMMMMMMqqqMqqqqqqqqqqqqqqqqqqqqqqqqqqqqqqqMqTTTTTTTTTTTTTTTTqMqqqqqqqqqqqqqqqqqqqqMfffffffffffMssZ
gggggggggggssssssssFqqqqqqqqqqqqqqqqqqqMQQQQQQQsMqqqMqqqqqqqqqqqqqqqqqqqqqqqqqqqqqqqMMMMMqqqqqqqqMMMMMMMMMMMMMqqqqqqqqqqqqqMMfffffffffffMssZ
gggggggggggssssssssFqqqqqqqqqqqqqqqqqqqMQQQQQQQsMMMMMqqqqqqqqqqqqqqqqqqqqqqqqqqqqqqqqqqqMqqqqqqqqMqqqqqqqqqqqMqqqqqqqqqqqqqMffffMMMMMMMMMssZ
ggggggggsssssssssssFFFFFFFFFFFFFFFMMMMMMQQssssssssssMqqqqqqqqqqqqqqqqqqqqqqqqqqqqqqqqqqqMqqqqqqqqMqqqqqqqqqqqMqqqqqqqqqqqqqMfffMMffffffMsssZ
ggggggggsgssssssssssssssssssssssssssssssssssssssssssMqqqqqqqqqqqqqqqqqqqqqqqqqqqqqqqqqqqMqqqqqqqqMqqqqqqqqqqqMqqqqqqqqqqqqqMffMMfffffffMsssZ
gggggggggggsssssssssssssssssssssssssssssssssssssssssMqqqqqqqqqqqqqqqqqqqqqqqqqqqqqqqqqqqMqqqqqqqqMqqqqqqqqqqqMMMMMMMMMMMMMMMffMffffffffMsssZ
ggggggggggggfffsssssssssssssssssssssssssssssssssssssMMMqqqqqqqqqqqqqqqqqqqqqqqqqqqqqqqqqMqqqqqqqqMqqqqqqqqqqqMffffffffffffffffMffffffffMsssZ
ggggggggggggffffffssssssssssssssssgggggsssssssssssssssMqqqqqqqqqqqqqqqqqqqqqqqqqqqqqqqqqMqqqqqqqqMMMfMMMMMMMMMffffffffffffffffMffffffffMsssQ
ggggggggggggfffffffssssssssssfffffggggggssssssssssssssMqqqqqqqqqqqqqqqqqqqqqqqqqqqqqqqqqMqqqqqqqqMfffffffffffMfffMMMMMMMMMMMMMMMMMMMMMMMsssQ
gggggggggggggffffffssssssssffffffggggggggsssssssssssssMqqqqqqqqqqqqqqqqqqqqqqqqqqqqqqqqqMqqqqqqqqffffffffffffffffMsssssssssssssssssssssssssQ
gggggggggggggfffffffsssssssffffffgggggggggssssssssssssMMMMMMMMMMMMMMMMMMMMMMqqMMMMMMMMMMMMMMMMMMMMMMMMMMMMMMMMMMMMsssssssssssssssssssssssssQ
ggggggggggggggffffffsssssssfffffggggggggggsssssssssssssssssssssssssssssssssMqqMsssssssssssssssssssssssssssssssssssssssssssssssssssssssssQQQQ
ggggggggggggggffffffssfsffffffffggggggggggsssssssssssssssssssssssssssssssssMqqMsssssssssssssssssssssssssssssssssssssssssssssssQQQQQQQQQQQQQQ
gggggggggggggggffffffffffffffffggggggggggggssssssssssssssssssssssssssssssssMqqMsssssssssssssssssssssssssssssssssssssssssssssssQQQQQQQQQQQQQQ
gggggggggggggggffffffffffffffffggggggggggggssssssssssssssssssssssssssssssssMqqMsssgggggggggggggggggggggggggLggggggfffffggggggLgggggggggggggg
ggggggggggggggggffffffffffffffggggggggggggggssssgsssssssssssssssssssgggggssMqqMsssgggggggggggggggggggggggggLggggggfffffggggggLgggggggggggggg
ggggggggggggggggffffffffffffffggggggggggggggggssgsssgsggssssssssssssssgsgggMqqMsgggggggggggggggggggggggggggLgggggfffffffgggggLgggggggggggggg
ggggggggggggggggggffffffffffggggggggggggggggggggggggggggssssssssgsssgggggssMqqMggggggggggggggggggggggggggggLLLLLLfffffffLLLLLLgggggggggggggg
ggggggggggggggggggggffffffgggggggggggggggggggggggggggggssssssssgggggggggggggqqgggggggggggggggggggggggggggggLggggfffffffffggggLgggggggggggggg
ggggggggggggggggggggggggggggggggggggggggggggggggggggggggggggggggggggggggggggqqgggggggggggggggggggggggggggggLggggfffffffffggggLgggggggggggggg
ggggggggggggggggggggggggggggggggggggggggggggggggggggggggggggggggggggggggggggqqgggggggggggggggggggggggggggggLgggfffffffffffgggLgggggggggggggg
ggggggggggggggggggggggggggggggggggggggggggggggggggggqqqqqqqqqqqqqqqqqqqqqqqqqqgggggggggggggggggggggggggggggLgggfffffffffffgggLgggggggggggggg
ggggggggggggggggggggggggggggggggggggggggggggggggggggqqqqqqqqqqqqqqqqqqqqqqqqqqgggggggggggggggggggggggggggggLLLfffffffffffffLLLgggggggggggggg
ggggggggggggggggggggggggggggggggggggggggggggggggggggqqqqqqqqqqqqqqqqqqqqqqqqqqgggggggggggggggggggggggggggggLggfffffffffffffggLgggggggggggggg
ggggggggggggggggggggggggggggggggggggggggggggggggggggqqqqqqqqqqqqqqqqqqqqqqqqqqgggggggggggggggggggggggggggggLggfffffffffffffggLgggggggggggggg
ggggggggggggggggggggggggggggggggggggggggggggggggggggqqqqqqqqqqqqqqqqqqqqqqqqqqgggggggggggggggggggggggggggggLggfffffffffffffggLgggggggggggggg
ggggggggggggggggggggggggggggggggggggggggggggggggggggqqqqqqqqqqqqqqqqqqqqqqqqqqgggggggggggggggggggggggggggggLgggfffffffffffgggLgggggggggggggg
ggggggggggggggggggggggggggggggggggggggggggggggggggggqqqqqqqqqqqqqqqqqqqqqqqqqqgggggggggggggggggggggggggggggLLLLfffffffffffLLLLgggggggggggggg
ggggggggggggggggggggggggggggggggggggggggggggggggggggqqqqqqqqqqqqqqqqqqqqqqqqqqggggggggggggggggggggggggggggggLgggfffffffffgggLggggggggggggggg
ggggggggggggggggggggggggggggggggggggggggggggggggggggqqqqqqqqqqqqqqqqqqqqqqqqqqggggggggggggggggggggggggggggggLgggfffffffffgggLggggggggggggggg
ggggggggggggggggggggggggggggggggggggggggggggggggggggqqqqqqqqqqqqqqqqqqqqqqqqqqggggggggggggggggggggggggggggggLLLLLfffffffLLLLLggggggggggggggg
ggggggggggggggggggggggggggggggggggggggggggggggggggggqqqqqqqqqqqqqqqqqqqqqqqqqqgggggggggggggggggggggggggggggggggggfffffffgggggggggggggggggggg
ggggggggggggggggggggggggggggggggggggggggggggggggggggqqqqqqqqqqqqqqqqqqqqqqqqqqgggggggggggggggggggggggggggggggggggggggggggggggggggggggggggggg
ggggggggggggggggggggggggggggggggggggggggggggggggggggqqqqqqqqqqqqqqqqqqqqqqqqqqgggggggggggggggggggggggggggggggggggggggggggggggggggggggggggggg
ggggggggggggggggggggggggggggggggggggggggggggggggggggqqqqqqqqqqqqqqqqqqqqqqqqqqgggggggggggggggggggggggggggggggggggggggggggggggggggggggggggggg
ggggggggggggggggggggggggggggggggggggggggggggggggggggqqqqqqqqqqqqqqqqqqqqqqqqqqgggggggggggggggggggggggggggggggggggggggggggggggggggggggggggggg
ggggggggggggggggggggggggggggggggggggggggggggggggggggqqqqqqqqqqqqqqqqqqqqqqqqqqgggggggggggggggggggggggggggggggggggggggggggggggggggggggggggggg
ggggggggggggggggggggggggggggggggggggggggggggggggggggqqqqqqqqqqqqqqqqqqqqqqqqqqgggggggggggggggggggggggggggggggggggggggggggggggggggggggggggggg
gggggggggggggggggggggggggggggggggggggggggggggggggggggggggggggggggggggggggggggggggggggggggggggggggggggggggggggggggggggggggggggggggggggggggggg
gggggggggggggggggggggggggggggggggggggggggggggggggggggggggggggggggggggggggggggggggggggggggggggggggggggggggggggggggggggggggggggggggggggggggggg
gggggggggggggggggggggggggggggggggggggggggggggggggggggggggggggggggggggggggggggggggggggggggggggggggggggggggggggggggggggggggggggggggggggggggggg
gggggggggggggggggggggggggggggggggggggggggggggggggggggggggggggggggggggggggggggggggggggggggggggggggggggggggggggggggggggggggggggggggggggggggggg
nggggggggggggggggggggggggggggggggggggggggggggggggggggggggggggggggggggggggggggggggggggggggggggggggggggggggggggggggggggggggggggggggggggggggggg
"}
