"a" = (/obj/structure/cable/heavyduty{icon_state = "2-4"},/turf/simulated/floor/plating,/area/greston/surfacebase/outside/outside1)
"b" = (/obj/structure/cable{d2 = 8; icon_state = "0-8"},/obj/structure/cable{d2 = 4; icon_state = "0-4"},/obj/machinery/power/grid_checker,/turf/simulated/floor/tiled,/area/greston/surfacebase/outside/outside1)
"c" = (/turf/simulated/floor/tiled/old_tile,/area/greston/surfacebase/outside/outside1)
"f" = (/turf/simulated/wall/r_wall,/area/greston/surfacebase/outside/outside1)
"g" = (/turf/simulated/mineral/lumos4,/area/greston/surfacebase/outside/outside1)
"h" = (/obj/machinery/power/smes/buildable/main,/obj/structure/cable{d2 = 4; icon_state = "0-4"},/turf/simulated/floor/tiled,/area/greston/surfacebase/outside/outside1)
"i" = (/obj/machinery/chemical_dispenser/bar_soft/full,/obj/structure/table/woodentable,/turf/simulated/floor/tiled,/area/greston/surfacebase/outside/outside1)
"j" = (/turf/simulated/floor/outdoors/dirt/lumos4,/area/greston/surfacebase/outside/outside1)
"k" = (/turf/unsimulated/wall/planetary/lumos4,/area/greston/surfacebase/outside/outside1)
"l" = (/obj/machinery/vending/boozeomat,/turf/simulated/floor/tiled,/area/greston/surfacebase/outside/outside1)
"m" = (/turf/simulated/floor/outdoors/grass/sif/lumos4,/area/greston/surfacebase/outside/outside1)
"n" = (/obj/machinery/vending/cola,/turf/simulated/floor/tiled,/area/greston/surfacebase/outside/outside1)
"o" = (/turf/simulated/wall/solidrock,/area/greston/surfacebase/outside/outside1)
"p" = (/obj/machinery/vending/fitness,/turf/simulated/floor/tiled,/area/greston/surfacebase/outside/outside1)
"q" = (/obj/machinery/power/terminal{dir = 1},/obj/structure/cable/heavyduty{icon_state = "0-8"},/turf/simulated/floor/plating,/area/greston/surfacebase/outside/outside1)
"r" = (/turf/simulated/floor/plating,/area/greston/surfacebase/outside/outside1)
"t" = (/obj/effect/step_trigger/teleporter/to_reactor,/obj/structure/cable/ender{icon_state = "4-8"; id = "surface-solars"},/turf/simulated/floor/plating,/area/greston/surfacebase/outside/outside1)
"u" = (/obj/structure/grille,/obj/machinery/door/firedoor/glass,/obj/structure/window/reinforced/full,/turf/simulated/floor/tiled,/area/greston/surfacebase/outside/outside1)
"v" = (/turf/simulated/wall,/area/greston/surfacebase/outside/outside1)
"w" = (/turf/simulated/floor/tiled,/area/hallway/primary/central_two)
"y" = (/obj/machinery/vending/giftvendor,/turf/simulated/floor/tiled,/area/greston/surfacebase/outside/outside1)
"z" = (/obj/structure/stairs/east,/turf/simulated/floor/tiled,/area/greston/surfacebase/outside/outside1)
"A" = (/obj/machinery/door/firedoor/glass/hidden/steel{dir = 2},/turf/simulated/floor/tiled,/area/hallway/primary/central_two)
"B" = (/turf/simulated/shuttle/wall/voidcraft/green{hard_corner = 1},/area/hallway/primary/central_two)
"C" = (/obj/structure/table/woodentable,/obj/machinery/chemical_dispenser/bar_coffee/full,/turf/simulated/floor/tiled,/area/greston/surfacebase/outside/outside1)
"E" = (/obj/structure/table/woodentable,/turf/simulated/floor/tiled,/area/greston/surfacebase/outside/outside1)
"F" = (/obj/structure/sink/kitchen{pixel_y = 28},/turf/simulated/floor/tiled,/area/greston/surfacebase/outside/outside1)
"G" = (/obj/machinery/vending/coffee,/turf/simulated/floor/tiled,/area/greston/surfacebase/outside/outside1)
"H" = (/obj/structure/grille,/obj/machinery/door/firedoor/glass,/turf/simulated/floor/tiled,/area/greston/surfacebase/outside/outside1)
"I" = (/turf/simulated/floor/tiled,/area/greston/surfacebase/outside/outside1)
"J" = (/turf/unsimulated/mineral/lumos4,/area/greston/surfacebase/outside/outside1)
"K" = (/obj/structure/bed/chair/comfy/brown{dir = 4},/turf/simulated/floor/tiled,/area/greston/surfacebase/outside/outside1)
"L" = (/turf/simulated/floor/tiled/monotile,/area/greston/surfacebase/outside/outside1)
"M" = (/obj/structure/bed/chair/comfy/brown{dir = 8},/turf/simulated/floor/tiled,/area/greston/surfacebase/outside/outside1)
"N" = (/obj/effect/step_trigger/teleporter/to_reactor,/turf/simulated/floor/tiled,/area/greston/surfacebase/outside/outside1)
"O" = (/obj/effect/step_trigger/teleporter/to_mining,/turf/simulated/floor/outdoors/dirt/lumos4,/area/greston/surfacebase/outside/outside1)
"P" = (/obj/structure/cable/heavyduty{icon_state = "1-2"},/turf/simulated/floor/plating,/area/greston/surfacebase/outside/outside1)
"Q" = (/obj/item/stool/padded,/turf/simulated/floor/carpet/bcarpet,/area/greston/surfacebase/outside/outside1)
"R" = (/obj/structure/cable/heavyduty{icon_state = "1-8"},/turf/simulated/floor/plating,/area/greston/surfacebase/outside/outside1)
"S" = (/obj/machinery/portable_atmospherics/hydroponics/soil,/turf/simulated/floor/outdoors/grass/sif/lumos4,/area/greston/surfacebase/outside/outside1)
"T" = (/obj/structure/cable/heavyduty{icon_state = "4-8"},/turf/simulated/floor/plating,/area/greston/surfacebase/outside/outside1)
"U" = (/obj/structure/cable{d1 = 4; d2 = 8; icon_state = "4-8"},/turf/simulated/floor/tiled,/area/greston/surfacebase/outside/outside1)
"V" = (/obj/structure/table/woodentable,/obj/machinery/cash_register/civilian,/turf/simulated/floor/tiled,/area/greston/surfacebase/outside/outside1)
"X" = (/obj/effect/step_trigger/teleporter/to_reactor,/turf/simulated/floor/outdoors/grass/sif/lumos4,/area/greston/surfacebase/outside/outside1)
"Y" = (/turf/simulated/floor/holofloor/tiled/dark,/area/hallway/primary/central_two)
"Z" = (/turf/simulated/floor/carpet/bcarpet,/area/greston/surfacebase/outside/outside1)

(1,1,1) = {"
JJJJJJJJJJJJJJJJJJJJJJJJJJJJJJJJJJJJJJJJJJJJJJJJJJJJJJJJJJJJJJJJJJJJJjjjJJJJJJJJJJJJJJJJJJJJJJJJJJJJJJJJJJJJJJJJJJJJJJJJJJJJJJJJJJJJJJJJJJJJ
JJJJJJJJJJJJJJJJJJJJJJJJJJJJJJJJJJJJJJJJJJJJJJJJJJJJJJJJJJJJJJgggggggjjjggggJJJJJJJJJJJJJJJJJJJJJJJJJJJJJJJJJJJJJJJJJJJJJJJJJJJJJJJJJJJJJJJJ
JooooooJJJJJJJJJJJJJJJJJJJJJJJJJJJJJJJJJJJJJJJJJJJJJJJJJJJJJJJgggggggOOOggggggJJJJJJJJJJJJJJJJJJJJJJJJJJJJJJJJJJJJJJJJJJJJJJJJJJJJJJJJJJJJJJ
oooooooooooooooooooooJJJggggggggggggggggggJJJJJJJJJooooooooooogggggjjjjjggjggggggooooooooooooJJJJJJJJJJJooooooooooooooooooooooooooooooooooJJ
oooooooooooooooooooooJJJgggggjggggggggggggggggggggggggggggggggggggjjjjjjjjjggggggooooooooooooJJJJJJJJJJJooooooooooooooooooooooooooooooooooJJ
oooooooogggggggooooooJJJgggggjjgggggggggggggggggggjjjggggggggggggjjjvjjjvjjggggggooooooooooooJJJJJJJJJJJooooooooooooooooooooooooooooooooooJJ
ogggggggggggggggggggggggggggjjjjjjgggggggggjjjjjjjjjjjjjjjjjjjjjjjjjjjjjjjjggggggooooooooooooJJJJJJJJJJJooooooooooooooooooooooooooooooooooJJ
kmgggggggggggggggjggggggggggjjjjjjjgggggggjjjjjjjjjjjjjjjjjjjjjjjjjjjjjjjjjjjggggooooooooooooJJJJJJJJJJJooooooooooooooooooooooooooooooooooJJ
kmmmmgggggjjjjjjjjjjjjjjjjgggjjgggjggggjjjjgggjjggggggggggggggggggjjvjjjvjjjjggggooooooooooooJJJJJJJJJJJooooooooooooooooooooooooooooooooooJJ
kmmmmggggjjjjjggggggggjjjjggjjjgggjjjjgggjggggggggggggggggggggggggjjjjjjjjjjgggggooooooooooooJJJJJJJJJJJooooooooooooooooooooooooooooooooooJJ
kmmmmggggjjjjggggggggggjjjjjjjjggggggjjjjjggggggggggggggggggggggggggggjjgggggggggooooooooooooJJJJJJJJJJJooooooooooooooooooooooooooooooooooJJ
kmmmmgggjjjjgggggggggggggggggggggggggjgggggggJJJJJJoooooooooooggggggggjjgggggggggooooooooooooJJJJJJJJJJJooooooooooooooooooooooooooooooooooJJ
kmmmmmgggjjggggggggggggggggggggggggggggggggJJJJJJJJoooooooooooggggggggjjgggggooooooooooooooooJJJJJJJJJJJooooooooooooooooooooooooooooooooooJJ
kmmmmmggvjjvgJJJJJJJJJJJJJJJJJJJJJJJJJJJJJJJJggggggggggggggggggggggggvIIvggggooooooooooooooooJJJJJJJJJJJooooooooooooooooooooooooooooooooooJJ
kmmmmmggvrrvJJJJJJJJJJJJJJJJJJJJJJJJJJJJJJJJggggggggggggggggggggggggvvIIvvggoooooooooooooooooJJJJJJJJJJJooooooooooooooooooooooooooooooooooJJ
kmmmmmmgvrrvgggggggggggggJJJJggggJJJJJJgggggggggggggggggggggggggggggvIIIIvggggggggggggggggggggggggggggggggggggggggggggggggggggggggggggggggJJ
kmmmmmmgvrrvggggggggggggggggggggggggggggggggggggggggggggggggggggggggvIIIIvggggggggggggggggggggggggggggggggggggggggggggggggggggggggggggggggJJ
kmmmmmmmvrrvmmmmmmmmmmmmmmmmmmmmmmmmmmmmmmmmmmmgggggggggggggggggggggvIIIIvggggggggggggggggggggggggggggggggggggggggggggggggggggggggggggggggJJ
kmmmmmmmvjjvmmmmmmmmmmmmmmmmmmmmmmmmmmmmmmmmmmmmggvvvvvvvvvvvvvvvvvvvvIIvvvvvvvvvvvvvvvvvvvvvvvvvvvvvvvvvvvvvvvvvvvvvvvvvvvvvvvvvvvvvvvgggJJ
kmmmmmmmmmmmmmmmmmmmmmmmmmmmmmmmmmmmmmmmmmmmmmmmmgvIIIIIIIIIIIIIIIIvIIIIIIvIIIIIIIIIIIIIIIIIIIvIIIIIIIIIIIIIIvIIIIIIIIIIIIrrrrrrrrrrrrvgggJJ
kmmmmmmmmmmmmmmmmmmmmmmmmmmmmmmmmmmmmmmmmmmmmmmmmmvIIIIIIIIIIIIIIIIIIIIIIIIIIIIIIIIIIIIIIIIIIIvIIIIIIIIIIIIIIvIIIIIIIIIIIIrrrrrrrrrrrrvgggJJ
kmmmmmmmmmmmmmmmmmmmmmmmmmmmmmmmmmmmmmmmmmmmmmmmmmvIIIIIIIIIIIIIIIIIIIIIIIIIIIIIIIIIIIIIIIIIIIvIIIIIIIIIIIIIIIIIIIIIIIIIIIrrrrrrrrrrrrvgggJJ
kmmmmmmmmmmmmmmmmmmmmmmmmmmmmmmmmmmmmmmmmmmmmmmmmmvIIIIIIIIIIIIIIIIvIIIIIIvIIIIIIIIIIIIIIIIIIIvIIIIIIIIIIIIIIIIIIIIIIIIIIIrrrrrrrrrrrrvgggJJ
kmmmmmmmmmmmmmmmmmmmmmmmmmmmmmmmmmmmmmmmmmmmmmmmvvvIIIIIIIIIIIIIIIIvvvIIvvvvvIIIIIIIIIIIIIIIIIIIIIIIIIIIIIIIIvvvvvvvvvvIIIrrrrrrrrrrrrvgggJJ
kmmmmmmmmmmmmmmmmmmmmmmmmmmmmmmmmmmmmmmmmmmmmmmmIIIIIIIIIIIIIIIIIIIvIIIIIIIIvIIIIIIIIIIIIIIIIIIIIIIIIIIIIIIIIIIIIIIIIIvIIIrrrrrrrrrrrrvgggJJ
kmmmmmmmmmmmmmmmmmmmmmmmmmmmmmmmmmmmmmmmmmmmmmmmIIIIIIIIIIIIIIIIIIIvIIIIIIIIvIIIIIIIIIIIIIIIIIvIIIIIIIIIIIIIIIIIIIIIIIvIIIrrrrrrrrrrrrvgggJJ
kmmmmmmmmmmmmmmmmmmmmmmmmmmmmmmmmmmmmmmmmmmmmmmmIIIIIIIIIIIIIIIIIIIvIIIIIIIIvvvvvvIIIIIIIIIIIIvIIIIIIIIIIIIIIIIIIIIIIIvIIIrrrrrrrrrrrrvgggJJ
kmmmmmmmmmmmmmmmmmmmmmmmmmmmmmmmmmmmmmmmmmmmmmmmvvvIIIIIIIIIIIIIIIIvIIIIIIIIIIIIIvIIIIIIIIIIIIvIIIIIIIIIIIIIIIIIIIIIIIvIIIrrrrrrrrrrrrvgggJJ
kmmmmmmmmmmmmmmmmmmmmmmmmmmmmmmmmmmmmmmmmmmmmmmmmmvIIIIIIIIIIIIIIIIvIIIIIIIIIIIIIIIIIIIIIIIIIIvIIIIIIIIIIIIIIIIIIIIIIIvIIIrrrrrrrrrrrrvgggJJ
kmmmmmmmmmmmmmmmmmmmmmmmmmmmmmmmmmmmmmmmmmmmmmmmmmvIIIIIIIIIIIIIIIIvIIIIIIIIIIIIIvIIIIIIIIIIIIvvvvvvvvvvvvIIvvvvvvvvIvvvvvvvvvrvvvvvvvvgggJJ
kmmmmmmmmmmmmmmmmmmmmmmmmmmmmmmmmmmmmmmmmmmmmmmmmmvIIIIIIIIIIIIIIIIvvvvvvvvvvvvvvvvvvIIvvIIvvvvIIIIIIIIIIIIIIIIIIIvIIIIIIvrrrrrrrrrrrrvgggJJ
kmmmmmmmmmmmmmmmmmmmmmmmmmmmmmmmmmmmmmmmmmmmmmmmmmvIIIIIIIIIIIIIIIIvIIIIIIIIIIIIIIIIIIIIIIIIIIIIIIIIIIIIIIIIIIIIIIvIIIIIIrrrrrrrrrrrrrvgggJJ
kmmmmmmmmmmmmmmmmmmmmmmmmmmmmmmmmmmmmmmmmmmmmmmmmmvIIIIIIIIIIIIIIIIvIIIIIIIIIIIIIIIIIIIIIIIIIIIIIIIIIIIIIIIIIIIIIIvIIIIIIvvvvvvvvvvvrrvgggoo
kmmmmmmmmmmmmmmmmmmmmmmmmmmmmmmmmmmmmmmmmmmmmmmmmmvIIIIIIIIIIIIIIIIvIIIIIIIIIIIIIIIIIIIIIIIIIIIIIIIIIIIIIIIIIIIIIIvIIIIIIIIIIIIIIIIvrrvgggoo
kmmmmmmmmmmmmmmmmmmmmmmmmmmmmmmmmmmmmmmmmmmmmmmmmmvIIIIIIIIIIIIIIIIvIIIIIIIIIIIIIIIIIIIIIIIIIIIIIIIIwwwwwwIIIIIIIIvIIIIIIIIIIIIIIIIvrrvgggoo
kmmmmmmmmmmmmmmmmmmmmmmmmmmmmmmmmmmmmmmmmmmmmvmvmmvIIIIIIIIIIIIIIIIvIIIIIIIIIIIIIIIIIIIIIIIIIIIIIIIIwwwwwwIIIIIIIIvIIIIIIIIIIIIIIIIvrrvgggoo
kmmmmmmmmmmmmmmmmmmmmmmmmmmmmmmmmmmmmmmmmmmmmmmmvmvIIIIIIIIIIIIIIIIvIIIIIIIIIIIIIIIIIIIIIIIIIIIIIIIIwwwwwwIIIIIIIIvIIIIIIIIIIIIIIIIvvrvgggoo
kmmmmmmmmmmmmmmmmmmmmmmmmmmmmmmmmmmmmmmmmmmmmvmvmmvIIIIIIIIIIIIIIIIvIIIIIIIIIIIIIIIIIIIIIIIIIIIIIIIIwwwwwwIIIIIIIIvIIIIIIIIIIIIIIIIvrrvgggoo
kmmmmmmmmmmmmmmmmmmmmmmmmmmmmmmmmmmmmmmmmmmmmmmmmmvIIIIIIIIIIIIIIIIvvvvvvvvvvvvvvvvvvvvvvvvvvvvvvvrvBBYYBBvvvvvIIIvIIIIIIIIIIIIIIIIvrrvgggoo
kmmmmmmmmmmmmmmmmmmmmmmmmmmmmmmmmmmmmmmmmmmmmmmmmmvIIIIIIIIIIIIvvIvvrrrrrrrrrrrrrrrrrrrrrrrrrrrrrrrvBYYYYBvrrrvIIIIIIIIIIIIIIIIIIIIvrrvgggoo
kmmmmmmmmmmmmmmmmmmmmmmmmmmmmmmmmmmmmmmmmmmmmmmmmmvIIIIIIIIIIIIvIIIvrrrrrrrrrrrrrrrrrrrrrrrrrrrrrrrvBYYYYBvrrrvIIIIIIIIIIIIIIIIIIIIvrrvgggoo
kmmmmmmmmmmmmmmmmmmmmmmmmmmmmmmmmmmmmmmmmmmmmmmmmmvIIIIIIIIIIIIvIIIrrrrvvvvvvvrvvvvvvvvvvvvvvvvvvvrvBYYYYBvrrrvIIIvIIIIIIIIIIIIIIIIvrrvgggoo
kmmmmmmmmmmmmmmmmmmmmmmmmmmmmmmmmmmmmmmmmmmmmmmmmmvIIIIIIIIIIIIvIIIvvvvvIIIIIIIIIIIIIIIIIIIIIIIIIvrvBYYYYBvrrrvIIIvIIIIIIIIIIIIIIIIvrrvgggoo
kmmmmmmmmmmmmmmmmmmmmfffffffffffffffffffvvvvvvvvvvvvvvvvvvvvvvvvvIvvIIIIIIIIIIIIIIIIIIIIIIIIIIIIIvrvBBBBBBvrrrvIIIvIIIIIIIIIIIIIIIIvrrvgggoo
kmmmmmmmmmmmmmmmmmmmffIIIIIIIIIIIIIIfIIIvIIIIIIIIIIIIIIIIIIIIIIIIIIIIIIIIIIIIIIIIIIIIIIIIIIIIIIIIvrvvvvvvvvrrrvIIIvIIIIIIIIIIIIIIIIvrrvgggoo
kmmmmmmmmmmmmmmmmmmffIIIIIIIIIIIIIIIfIIIIIIIIIIIIIIIIIIIIIIIIIIIIIIIIIIIIIIIIIIIIIIIIIIIIIIIIIIIIvrrrrrrrrrrrrrIIIvIIIIIIIIIIIIIIIIvrrvgggoo
kmmmmmmmmmmmmmmmmmffIIIIIIIIIIIIIIIIfIIIvIIIIIIIIIIIIIIIIIIIIIIIIIIIIIIIIIIIIIIIIIIIIIIIIIIIIIIIIvrrrrrrrrrrrrvIIIvIIIIIIIIIIIIIIIIvrrvgggoo
kmmmmmmmmmmmmmmmmmfIIIIIIIIIIIIIIIIIfIIIvvvIvvvvvvvvvvvvvvvvvvvvvvvvIIIIIIIIIIIIIIIIIIIIIIIIIIIIIvvvvvvvrvvvvvvIIIvIIIIIIIIIIIIIIIIvrrvgggoo
kmmmmmmmmmmmmmmmmmfIIIIIIIIIIIIIIIIIfIIIvIIIIvIIIIIIIIIIIIIIIIIIIIIIIIIIIIIIIIIIIIIIIIIIIIIIIIIIIIIIIIIIIIIIIIvIIIvIIIIIIIIIIIIIIIIvrrvgggoo
kmmmmmmmmmmmmmmmmmffIIIIIIIIIIIIIIIIfIIIvIIIIvIIIIIIIIIIIIIIIIIIIIIIIIIIIIIIIIIIIIIIIIIIIIIIIIIIIIIIIIIIIIIIIIvIIIvIIIIIIIIIIIIIIIIvrrvgggoo
kmmmmmmmmmmmmmmmmmmffIIIIIIIIIIIIIIIfIIIvIIIIvIIIIIIIIIIIIIIIIIIIIIIIIIIIIIIIIIIIIIIIIIIIIIIIIIIIIIIIIIIIIIIIIvIIIvIIIIIIIIIIIIIIIIvrrvgggoo
kmmmmmmmmmmmmmmmmmmmffIIIIIIIIIIIIIIfIIIvIIIIvIIIIIIIIIIIIIIIIIIIIIIIIIIIIIIIIIIIIIIIIIIIIIIIIIIIIIIIIIIIIIIIIvIIIvvvvvvvvvvvvvvvvvvrrvgggoo
kmmmmmmmmmmmmmmmmmmmmfffffffffIIIIIIfIIIvIIIIvIIIIIIIIIIIIIIIIIIIIIIIIIIIIIIIIIIIIIIIIIIIIIIIIIIIIIIIIIIIIIIIIvIIIvrrrrrrrrrrrrrrrrrrrvgggoo
kmmmmmmvvvvvvvvvmmmmmmmmmmmmmvIIIIIIIIIIvIIIIvIIIIIIIIIIIIIIIIIIIIIIIIIIIIIIIIIIIIIIIIIIIIIIIIIIIIIIIIIIIIIIIIvIIIrrrrrrrrrrrrrrrrrrrrvgggoo
kmmmmmmvIhUUUUbUUUUUUUImmmmmmvIIIIIIIIIIvIIIIvIIIIIIIIIIIIIIIIIIIIIIIIIIIIIIIIIIIIIIIIIIIIIIIIIIIIIIIIIIIIIIIIvIIIvvvvvvvvvvvvvvIvvvrrvgggoo
kmmmmaTTTqIIIIIvmmmmmmImmmmmmvIIIIIIIIIIvIIIIvIIIIIIIIIIIIIIIIIIIIIIIIIIIIIIIIIIIIIIIIIIIIIIIIIIIIIIIIIIIIIIIIvIIIvIIIIIIIIvIIIIIIIvrrvgggoo
kmmmmPmvIIIIIIIvmmmmmmImmmmmmvIIIIIIIIIIvIIIIvIIIIIIIIIIIIIIIIIIIIIIIIIIIIIIIIIIIIIIIIIIIIIIIIIIIIIIIIIIIIIIIIvIIIvIIIIIIIIIIIIIIIIvrrvgggoo
kmmmmPmvvvIIvvvvmmmmmmImmmmmmvvvvvvvvvvvvvuuvvvuuvuuvuuvvvvvvvvvvvvIIIIIIIIIIIIIIIIIIIIIIIIIIIIIIIIIIIIIIIIIIIvIIIvIIIIIIIIvIIIIIIIvrrvgggoo
kmmmmPmmmmImmmmmmmmmmmIvvvvvvvIIIIIIIIIIIIIIIIIIIIIIIIIIIIIIIIIIIIvvvIIIIIIIIIIIIIIIIIIIIIIIIIIIIIIIIIIIIIIIIIvIIIvIIIIIIIIvIIIIIIIvrrvgggoo
tTTTTRmmmmmImmmmmmmmmmIIIIIIIIIIIIIIIIIIIIIIIIIIIIIIIIIIIIIIIIIIIIIIvvvIIIIIIIIIIIIIIIIIIIIIIIIIIIIIIIIIIIIIIIvIIIIIIIIIIIIIIIIIIIIvrrvgggoo
XmImmImmmIImmmmmImmIIIIIIIIIIIIIIIIIIIIIIIIIIIIIIIIIIIIIIIIIIIIIIIIIIIvvvIIIIIIIIIIIIIIIIIIIIIIIIIIIIIIIIIIIIIvIIIvIIIIIIIIIIIIIIIIvrrvgggoo
NImmmmImmmmIImIIIImIIIIvIIIIIvIIIIIIIIIIIIIIIvvvvvvvvvvvvvvvvIIIIIIIIIIIvvvIIIIIIIIIIIIIIIIIIIIIIIIIIIIIIIIIIIvIIIvvvvvvvvvvIIIIIIIvrrvgggoo
XImImmmImIIIIIImIImIIIIIIIIIIIIIIIIIIIIIIIIIIvrrrrrrrrrrrrrrvvvIIIIIIIIIIIvIIIIIIIIIIIIIIIIIIIIIIIIIIIIIIIIIIIvIIIvIIIIIIIIIIIIIIIIvrrvgggoo
XmmmmmmmmmmmmmmmmmmmmmmIIIIIIIIIIIIIIIIIIIIIIvrrrrrrrrrrrrrrrrvvvIIIIIIIIIvvIIIIIIIIIIIIIIIIIIIIIIIIIIIIIIIIIIvIIIvIIIIIIIIIIIIIIIIrrrvgggoo
kmmmmmmmmmmmmmmmmmmmmmmvvvvvvvIIIIIIIIIIIIIIIvrrvvvvvvvvvvvrrrrrvvvIIIIIIIIvIIIIIIIIIIIIIIIIIIIIIIIIIIIIIIIIIIvIIIvIIIIIIIIIIIIIIIIvrrvgggoo
kmmmmmmmmmmmmmmmmmmmmmmmmmmmmvvIvvvvvvvvvvvvvvrrvIIIIIIIIIvvvrrrrrvvvIIIIIIvvIIIIIIIIIIIIvvIvvIIIIIIIIIIIIIIIIvIIIvIIIIIIIIIIIIIIIIvrrvgggoo
kmmmmmmmmmmmmmmmmmmmmmmmmmmmmvIIIvrrrrrrrrrrrrrrvIIIIIIIIIIIvvvrrrrrvIIIIIIIvIIIIIIIIIIIIvIIIvIIIIIIIIIIIIIIIIvIIIvIIIIIIIIIIIIIIIIvrrvgggoo
kmmmmmmmmmmmmmmmmmmmmmmmmmmmmvIIIrrrrrrrrrrrrrrrvIIIIIIIIIIIIIvvvrrrvvIIIIIIvvIIIIIIIIIIIvIIIvIIIIIIIIIIIIIIIIvIIIvIIIIIIIIIIIIIIIIvrrvgggoo
kmmmmmmmmmmmmmmmmmmmmmmmmmmmmvIIIvvvvvvvvvvvrvvvvIIIIIIIIIIIIIIIvvvrrvIIIIIIIvIIIIIIIIIIIvIIIvIIIIIIIIIIIIIIIIvIIIvIIIIIIIIIIIIIIIIvrrvgggoo
kmmmmmmmmmmmmmmmmmmmmmmmmmmmmvIIIvIIIIIIIIIIIIIIIIIIIIIIIIIIIIIIIIvrrvvIIIIIIvvvvvvvvvvvvvvIvvvvvvvvvvvvvvvvvvvIIIvIIIIIIIIIIIIIIIIvrrvgggoo
kmmmmmmmmmmmmmmmmmvvvvvvvvvvvvvIvvIIIIIIIIIIIIIIIIIIIIIIIIIIIIIIIIvrrrvIIIIIIIIIIIIIIIIIIIIIIIIIIIIIIIIIIIIIIIIIIIvIIIIIIIIIIIIIIIIvrrvgggoo
kmmmmmmmmmmmmmmmmvvIIIIIIIIIIIIIIIIIIIIIIIIIIIIIIIIIIIIIIIIIIIIIIIvvrrvvIIIIIIIIIIIIIIIIIIIIIIIIIIIIIIIIIIIIIIIIIIvIIIIIIIIIIIIIIIIvrrvgggoo
kmmmmmmmmmmmmmmmvvIIIIIIIIIIIIIIIIIIIIIIIIIIIIIIIIIIIIIIIIIIIIIIIIIvrrrvIIIIIIIIIIIIIIIIIIIIIIIIIIIIIIIIIIIIIIIIIIvIIIIIIIIIIIIIIIIvrrvgggoo
kmmmmmmmmmmmmmmvvIIIIIIIIIIIIIIIIIIIIIIIIIIIIIIIIIIIIIIIIIIIIIIIIIIvvrrvvIIIIIIIIvvvvvvIIIIIIIIIIvvrvvvvvvvvvvvIIIvIIIIIIIIIIIIIIIIvrrvgggoo
kmmmmmmmmmmmmmvvIIIIIIIIIIIIIIIIIIIIIIIIIIIIIIIIIIIIIIIIIIIIIIIIIIIIvrrrvIIIIIIIIIIIIIIIIIIIIIIIIvrrvIIIIIIIIIvIIIvIIIIIIIIIIIIIIIIvrrvgggoo
kmmmmmmmmmmmmvvIIIIIIIIIIIIIIIIIIIIIIIIIIIIIIIIIIIIIIIIIIIIIIIIIIIIIvvrrvIIIIIIIIIIIIIIIIIIIIIIIIvrrvIIIIIIIIIvIIIvIIIIIIIIIIIIIIIIvrrvgggoo
kmmmmmmmmmmmvvIIIIIIIIIIIIIIIIIIIIIIIIIIIIIIIIIIIIIIIIIIIIIIIIIIIIIIIvrrvIIIIIIIIIIIIIIIIIIIIIIIIvrrvIIIIIIIIIvIIIvvvvvvvvvvvvvvvvvvrrvgggoo
kmmmmmmmmmmmvIIIIIIIIIIIIIIIIIIIIIIIIIIIIIIIIIIIIIIIIIIIIIIIIIIIIIIIIvrrvIIIIIIIIIIIIIIIIIIIvvvvvvrrvIIIIIIIIIvIIIIIIIIIIIIIIIIIIIIvrrvgggoo
kmmmmmmmmmmmvIIIIIIIIIIIIIIIIIIIIIIIIIIIIIIIIIIIIIIIIIIIIIIIIIIIIIIIIvrrvIIIIIIIIIIIIIIIIIIIvIIIIvrrvIIIIIIIIIvIIIIIIIIIIIIIIIIIIIIvrrvgggoo
kmmmmmmmmmmmvIIIIIIIIIIIIIIIIIIIIIIIIIIIIIIIIIIIIIIIIIIIIIIIIIIIIIIIIvrrvIIIIIIIIvvvvvvIIIIIvIIIIvrrrIIIIIIIIIvIIIuIIIIIIIIIIIIIIIIvrrvgggoo
kmmmmmmmmmmmvIIIIIIIIIIIIIIIIIIIIIIIIIIIIIIIIIIIIIIIIIIIIIIIIIIIIIIIIvrrvIIIIIIIIIIIIIIIIIIIvIIIIvrrvIIIIIIIIIvIIIIIIIIIIIIIIIIIIIIvrrvgggoo
kmmmmmmmmmmmvIIIIIIIIIIIIIIIIIIIIIIIIIIIIIIIIIIIIIIIIIIIIIIIIIIIIIIIIvrrvIIIIIIIIIIIIIIIIIIIIIIIIvrrvIIIIIIIIIvIIIIIIIIIIIIIIIIIIIIvrrvgggoo
kmmmmmmmmmmmvIIIIIIIIIIIIIIIIIIIIIIIIIIIIIIIIIIIIIIIIIIIIIIIIIIIIIIIIvrrvIIIIIIIIIIIIIIIIIIzvIIIIvrrvIIIIIIIIIvIIIvvvvvvvvvvvvvvvvvvrrvgggoo
kmmmmmmmmmmmvIIIIIIIIIIIIIIIIIIIIIIIIIIIIIIIIIIIIIIIIIIIIIIIIIIIIIIIIvrrvIIIIIIIIIIIIIIIIIIzvIIIIvrrvIIIIIIIIIIIIIvrrrrrrrrrrrrrrrrrrrvgggoo
kmmmmmmmmmmmvIIIIIIIIIIIIIIIIIIIIIIIIIIIIIIIIIIIIIIIIIIIIIIIIIIIIIIIIvrrvIIIvvvvvvvvvvvvvvvvvvvvvvrrvIIIIIIIIIIIIIrrrrrrrrrrrrrrrrrrrrvgggoo
kmmmmmmmmmmmfIIIIIIIIIIIIIIIIIIIIIIIIIIIIIIIIIIIIIIIIIIIIIIIIIIIIIIIIvrrvIIIvrrrrrrrrrrrrrrrrrrrrrrrvIIIIIIIIIvIIIvvvvvvvvvvvvvvvvvvrvvgggoo
kmmmmmmmmmmmfIIIIIIIIIIIIIIIIIIIIIIIIIIIIIIIIIIIIIIIIIIIIIIIIIIIIIIIIvrrrIIIrrrrrrrrrrrrrrrrrrrrrrrrvIIIIIIIIIvIIIIIIIIIIIIIIvIIIIIIIIvgggoo
kmmmmmmmmmmmfIIIIIIIIIIIIIIIIIIIIIIIIIIIIIIIIIIIIIIIIIIIIIIIIIIIIIIIIvvvvIIIvvvvvvvvvvvvvrrrrrrrrvrrvIIIIIIIIIvIIIIIIIIIIIIIIvIIIIIIIIvgggoo
kmmmmmmmmmmmfIIIIIIIIIIIIIIIIIIIIIIIIIIIIIIIIIIIIIIIIIIIIIIIIIIIIIIIIIIIvIIIIIIIIIIIIIIIvrvvvvvvvvrrvIIIIIIIIIvIIIIIIIIIIIIIIvIIIIIIIIvgggoo
kmmmmmmmmmgmfIIIIIIIIIIIIIIIIIIIIIIIIIIIIIIIIIIIIIIIIIIIIIIIIIIIIIIIIIIIvIIIIIIIIIIIIIIIvrvBBBBBBvrrvIIIIIIIIIvIIIIIIIIIIIIIIvIIIIIIIIvgggoo
kmmmmmmmmgggfIIIIIIIIIIIIIIIIIIIIIIIIIIIIIIIIIIIIIIIIIIIIIIIIIIIIIIIIIIIvIIIIIIIIIIIIIIIvrvBYYYYBvrrvIIIIIIIIIvIIIIIIIIIIIIIIvIIIIIIIIvgggoo
kmmmmmmmmmggfIIIIIIIIIIIIIIIIIIIIIIIIIIIIIIIIIIIIIIIIIIIIIIIIIIIIIIIIIIIvIIIIIIIIIIIIIIIvrvBYYYYBvrrvIIIIIIIIIvIIIIIIIIIIIIIIvvvvvIvvvvgggoo
kmmmmmmmmmmmfIIIIIIIIIIIIIIIIIIIIIIIIIIIIIIIIIIIIIIIIIIIIIIIIIIIIIIIIIIIvIIIIIIIIIIIIIIIvrvBYYYYBvrrvIIIIIIIIIvIIIIIIIIIIIIIIIIIIIIIIIvgggoo
kmmmmmmmmmmgfIIIIIIIIIIIIIIIIIIIIIIIIIIIIIIIIIIIIIIIIIIIIIIIIIIIIIIIIIIIvIIIIIIIIIIIIIIIvrvBYYYYBvrrvIIIIIIIIIvIIIIIIZZZZZZZZZZZZZIIIIvgggoo
kmmmmmmmmmggfIIIIIIIIIIIIIIIIIIIIIIIIIIIIIIIIIIIIIIIIIIIIIIIIIIIIIIvvvvvvIIIIIIIIIIIIIIIvrvBBYYBBvrrvvvvvvvvvvvIIIIIIZZZZZZZZZZZZZIIIIvgggoo
kmmmmmmmmgggfIIIIIIIIIIIIIIIIIIIIIIIIIIIIIIIIIIIIIIIIIIIIIIIIIIIIIIvIIIIvIIIIIIIIIIIIwwwwwwwwAAwwwwwwwwIIIIIIIIIIIIIIZZZZZZZZZZZZZIIIIvgggJJ
kmmmmmmmmgggfIIIIIIIIIIIIIIIIIIIIIIIIIIIIIIIIIIIIIIIIIIIIIIIIIIIIIIIIIIIIIIIIIIIIIIIIwwwwwwwwwwwwwwwwwwIIIIIIIIIIIIIIZZZEEVvvIvZZZIIIIvgggJJ
kmmmmmmmmmggfIIIIIIIIIIIIIIIIIIIIIIIIIIIIIIIIIIIIIIIIIIIIIIIIIIIIIIvIIIIvIIIIIIIIIIIIwwwwwwwwwwwwwwwwwwIIIIIIIIIIIIIIZZQEIIFIIEQZZIIInvgggJJ
kmmmmmmmmmmmfIIIIIIIIIIIIIIIIIIIIIIIIIIIIIIIIIIIIIIIIIIIIIIIIIIIIIIvvvvvvvvvvvvvvvvvvvvrvIIIIIIIIvrrvIIIIIIIIIIIIIIIIZZZEIIIIIEZZZIIIGvgggJJ
kmmmmmmmmmmmfIIIIIIIIIIIIIIIIIIIIIIIIIIIIIIIIIIIIIIIIIIIIIIIIIIIIIIIIIIIIIIIIIIIIIIIIvrrvIIIIIIIIvrrvIIIIIIIIIIIIIIIIZZQEICilIEQZZIIIpvgggJJ
kmmmmmmmggggfIIIIIIIIIIIIIIIIIIIIfvvvvvvvvvvvvIIIIIIIIIIIIIIIIIIIIIIIIIIIIIIIIIIIIIIIvrrvIIIIIIIIvrrvIIIIIIIIIIIIIIIIZZZEIIIIIEZZZIIIpvgggJJ
kmmmmmmmgmggfIIIIIIIIIIIIIIIIIIIIfgggggggggggvIIIIIIIIIIIIIIIIIIIIIIIIIIIIIIIIIIIIIIIvrrvIIIIIIIIvrrvIIIIIIIIIIIIIIIIZZQEIIIIIEQZZIIIyvgggJJ
kmmmmmmmmmmgfvvvvvvvvvIIvvvvvvvvvfgggggggggggvIIIIIIIIIIIIIIIIIIIIIIIIIIIIIIIIIIIIIIIvrrvIIIIIIIIvrrvIIIIIIIIIIIIIIIIZZZEEEEEEEZZZIIIIvgggJJ
kmmmmmmmmmmmuccccccccccccccccccccugggggggggggvIIIIIIIIIIIIIIIIIIIIIIIIIIIIIIIIIIIIIIIvrrvIIIIIIIIvrrvvvvIvvIIIIIIIIIIZZZZQZQZQZZZZIIIIvgggJJ
kmmmmmmmmmmmuccccccccccccccccccccummmmmggggggvIIIIIIIIIIIIIIIIIIIIIIIIIIIIIIIIIIIIIIIvrrvIIIIIIIIvrrvIIIIIvIIIIIIIIIIZZZZZZZZZZZZZIIIIvgggoo
kmmmmmmmmmmmuuccccccccccccccccccuummmmmmgggggvIIIIIIIIIIIIIIIIIIIIIIIIIIIIIIIIIIIIIIIvrrvIIIIIIIIvrrvIIIIIvIIvIIvIIIIZZZZZZZZZZZZZIIIIvggggo
kmmmmmmmmmmmmuccccccccccccccccccummmmmmmmggggvIIIIIIIIIIIIIIIIIIIIIIIIIIIIIIIIIIIIIIIvrrvIIIIIIIIvrrrIIIIIvIIIIIvIIIIIIIIIIIIIIIIIIIIIvggggo
kmmmmmmmmmmmmuuccccccvccvccccccuummmmmmmmmgggvIIIIIIIIIIvvrvvvvvvvvvvvvvvvvvvvvvvvvvvvrvvvvvvvvvvvrrvIIIIIIIIIIIvIIIIIKEMIKEMIKEMIIIIIvggggo
kmmmmmmmmmmmmmuccccccvccvccccccummmmmmmmmmgggvIIIIIIIIIIvrrrrrrrrrrrrrrrrrrrrrrrrvrrrvrrrrrrrrrrrrrrvIIIIIuIIIIIvIKEMIKEMIKEMIKEMIKEMIvggggo
kmmmmmmmmmmmmmuucccccvccvcccccuummmmmmmmmmgggvIIIIIIIIIIvrrrrrrrrrrrrrrrrrrrrrrrrrrrrrrrrrrrrrrrrrrrvIIIIIvIIIIIvIKEMIKEMIKEMIKEMIKEMIvggggo
kmmmmmmmmmmmmmmffuuuuvccvuuuuffmmmmmmmmmmmgggvvvvvvvvvvvvvvvvvvvvvvvvvvvvvvvvvvvvvvrvvvvvvvvvvvvvvvvvvuuuvvIIvIIvvuuuvuuuvuuuvuuuvuuuvvkkkkk
kmmmmmmmmmmmmmmffcSSccccccSScffmmmmmmmmmmmgggggggggggggggggggggggggggmmmgggggggggggggmggggmgggggmLLLLLLLLLLLLLLLLLLLLLLLLLLLLLLLLLLLLmmmmmmk
kmmmmmmmmmmmmmmmuccccccccccccummmmmmmmmmmmmgggggmgggggggggggggggggggmmmmmgggggggggmmmmgggmmgggggmLLLLLLLLLLLLLLLLLLLLLLLLLLLLLLLLLLLLmmmmmmk
kmmmmmmmmmmmmmmmuuuSSccccSSuuummmmmmmmmmmmmmmmggmgggmgmmggggggggmgggggmgmmmgggggmmmggggggmmmggmmmLLLLLLLLLLLLLLLLLLLLLLLLLLLLLLLLLLLLmmmmmmk
kmmmmmmmmmmmmmmmmmuuuccccuuummmmmmmmmmmmmmmmmmmmmmmmmmmmggggggggmgggmmmmmggmgggmmmmmgmmgmmmmmmmmmLLLLLLLLLLLLLLLLLLLLLLLLLLLLLLLLLLLLmmmmmmk
kmmmmmmmmmmmmmmmmmmmuuHHuummmmmmmmmmmmmmmmmmmmmmmmmmmmmggggggggmmmgmmmmmmmmmmmmmmmmmggmmmmmmmmmmmLLLLLLLLLLLLLLLLLLLLLLLLLLLLLLLLLLLLmmmmmmk
kmmmmmmmmmmmmmmmmmmmmmmmmmmmmmmmmmmmmmmmmmmmmmmmmmmmmmmmmmmmmmmmmmmmmmmmmmmmmmmmmmmmmmmmmmmmmmmmmIIIIIIIIIIIIIIIIIIIIIIIIIIIIIIIIIIIImmmmmmk
kmmmmmmmmmmmmmmmmmmmmmmmmmmmmmmmmmmmmmmmmmmmmmmmmmmmmmmmmmmmmmmmmmmmmmmmmmmmmmmmmmmmmmmmmmmmmmmmmIIIIIIIIIIIIIIIIIIIIIIIIIIIIIIIIIIIImmmmmmk
kmmmmmmmmmmmmmmmmmmmmmmmmmmmmmmmmmmmmmmmmmmmmmmmmmmmvmmmmmmmmmmmmmmmmmmmmmmmmvmmmmmmmmmmmmmmmmmmmIIIIIIIIIIIIIIIIIIIIIIIIIIIIIIIIIIIImmmmmmk
kmmmmmmmmmmmmmmmmmmmmmmmmmmmmmmmmmmmmmmmmmmmmmmmmmmmmmmmmmmmmmmmmmmmmmmmmmmmmmmmmmmmmmmmmmmmmmmmmIIIIIIIIIIIIIIIIIIIIIIIIIIIIIIIIIIIImmmmmmk
kmmmmmmmmmmmmmmmmmmmmmmmmmmmmmmmmmmmmmmmmmmmmmmmmmmmmmmmmmmmmmmmmmmmmmmmmmmmmmmmmmmmmmmmmmmmmmmmmIIIIIIIIIIIIIIIIIIIIIIIIIIIIIIIIIIIImmmmmmk
kmmmmmmmmmmmmmmmmmmmmmmmmmmmmmmmmmmmmmmmmmmmmmmmmmmmmmmmmmmmmmmmmmmmmmmmmmmmmmmmmmmmmmmmmmmmmmmmmIIIIIIIIIIIIIIIIIIIIIIIIIIIIIIIIIIIImmmmmmk
kmmmmmmmmmmmmmmmmmmmmmmmmmmmmmmmmmmmmmmmmmmmmmmmmmmmmmmmmmmmvmmmmmmmvmmmmmmmmmmmmmmmmmmmmmmmmmmmmIIIIIIIIIIIIIIIIIIIIIIIIIIIIIIIIIIIImmmmmmk
kmmmmmmmmmmmmmmmmmmmmmmmmmmmmmmmmmmmmmmmmmmmmmmmmmmmmmmmmmmmmmmmmmmmmmmmmmmmmmmmmmmmmmmmmmmmmmmmmIIIIIIIIIIIIIIIIIIIIIIIIIIIIIIIIIIIImmmmmmk
kmmmmmmmmmmmmmmmmmmmmmmmmmmmmmmmmmmmmmmmmmmmmmmmmmmmmmmmmmmmmmmmmmmmmmmmmmmmmmmmmmmmmmmmmmmmmmmmmIIIIIIIIIIIIIIIIIIIIIIIIIIIIIIIIIIIImmmmmmk
kmmmmmmmmmmmmmmmmmmmmmmmmmmmmmmmmmmmmmmmmmmmmmmmmmmmmmmmmmmmmmmmmmmmmmmmmmmmmmmmmmmmmmmmmmmmmmmmmIIIIIIIIIIIIIIIIIIIIIIIIIIIIIIIIIIIImmmmmmk
kmmmmmmmmmmmmmmmmmmmmmmmmmmmmmmmmmmmmmmmmmmmmmmmmmmmmmmmmmmmmmmmmmmmmmmmmmmmmmmmmmmmmmmmmmmmmmmmmIIIIIIIIIIIIIIIIIIIIIIIIIIIIIIIIIIIImmmmmmk
kmmmmmmmmmmmmmmmmmmmmmmmmmmmmmmmmmmmmmmmmmmmmmmmmmmmmmmmmmmmmmmmmmmmmmmmmmmmmmmmmmmmmmmmmmmmmmmmmIIIIIIIIIIIIIIIIIIIIIIIIIIIIIIIIIIIImmmmmmk
kmmmmmmmmmmmmmmmmmmmmmmmmmmmmmmmmmmmmmmmmmmmmmmmmmmmmmmmmmmmmmmmmmmmmmmmmmmmmmmmmmmmmmmmmmmmmmmmmIIIIIIIIIIIIIIIIIIIIIIIIIIIIIIIIIIIImmmmmmk
kmmmmmmmmmmmmmmmmmmmmmmmmmmmmmmmmmmmmmmmmmmmmmmmmmmmmmmmmmmmmmmmmmmmmmmmmmmmmmmmmmmmmmmmmmmmmmmmmIIIIIIIIIIIIIIIIIIIIIIIIIIIIIIIIIIIImmmmmmk
kmmmmmmmmmmmmmmmmmmmmmmmmmmmmmmmmmmmmmmmmmmmmmmmmmmmmmmmmmmmmmmmmmmmmmmmmmmmmmmmmmmmmmmmmmmmmmmmmIIIIIIIIIIIIIIIIIIIIIIIIIIIIIIIIIIIImmmmmmk
kmmmmmmmmmmmmmmmmmmmmmmmmmmmmmmmmmmmmmmmmmmmmmmmmmmmmmmmmmmmvmmmmmmmvmmmmmmmmmmmmmmmmmmmmmmmmmmmmIIIIIIIIIIIIIIIIIIIIIIIIIIIIIIIIIIIImmmmmmk
kmmmmmmmmmmmmmmmmmmmmmmmmmmmmmmmmmmmmmmmmmmmmmmmmmmmmmmmmmmmmmmmmmmmmmmmmmmmmmmmmmmmmmmmmmmmmmmmmIIIIIIIIIIIIIIIIIIIIIIIIIIIIIIIIIIIImmmmmmk
kmmmmmmmmmmmmmmmmmmmmmmmmmmmmmmmmmmmmmmmmmmmmmmmmmmmmmmmmmmmmmmmmmmmmmmmmmmmmmmmmmmmmmmmmmmmmmmmmIIIIIIIIIIIIIIIIIIIIIIIIIIIIIIIIIIIImmmmmmk
kmmmmmmmmmmmmmmmmmmmmmmmmmmmmmmmmmmmmmmmmmmmmmmmmmmmvmmmmmmmmmmmmmmmmmmmmmmmmvmmmmmmmmmmmmmmmmmmmIIIIIIIIIIIIIIIIIIIIIIIIIIIIIIIIIIIImmmmmmk
kmmmmmmmmmmmmmmmmmmmmmmmmmmmmmmmmmmmmmmmmmmmmmmmmmmmmmmmmmmmmmmmmmmmmmmmmmmmmmmmmmmmmmmmmmmmmmmmmmmmmmmmmmmmmmmmmmmmmmmmmmmmmmmmmmmmmmmmmmmk
kmmmmmmmmmmmmmmmmmmmmmmmmmmmmmmmmmmmmmmmmmmmmmmmmmmmmmmmmmmmmmmmmmmmmmmmmmmmmmmmmmmmmmmmmmmmmmmmmmmmmmmmmmmmmmmmmmmmmmmmmmmmmmmmmmmmmmmmmmmk
kmmmmmmmmmmmmmmmmmmmmmmmmmmmmmmmmmmmmmmmmmmmmmmmmmmmmmmmmmmmmmmmmmmmmmmmmmmmmmmmmmmmmmmmmmmmmmmmmmmmmmmmmmmmmmmmmmmmmmmmmmmmmmmmmmmmmmmmmmmk
kmmmmmmmmmmmmmmmmmmmmmmmmmmmmmmmmmmmmmmmmmmmmmmmmmmmmmmmmmmmmmmmmmmmmmmmmmmmmmmmmmmmmmmmmmmmmmmmmmmmmmmmmmmmmmmmmmmmmmmmmmmmmmmmmmmmmmmmmmmk
kkkkkkkkkkkkkkkkkkkkkkkkkkkkkkkkkkkkkkkkkkkkkkkkkkkkkkkkkkkkkkkkkkkkkkkkkkkkkkkkkkkkkkkkkkkkkkkkkkkkkkkkkkkkkkkkkkkkkkkkkkkkkkkkkkkkkkkkkkkk
"}
